winter
...#......f
..##.#.####
.##..###..#
##...@.....
.......#..#
###..###..#
..#..#....#
.##.##.#.##
.#......##.
.#.....##..
.#####.#...