winter
...#......f
..##e#.####
.##..###..#
##...@...m.
.......#..#
###..###..#
..#..#....#
.##.##.#.##
.#......##.
.#.....##..
.#####.#...