summer
...###.....
..##.#.####
.##..###..#
##...@....#
#......#..#
###..###..#
..#..#....#
.##.##.#.##
.#......##.
.#.....##..
.#######...