water
....v...#@.
..#.....#..
.#...#....h
.#.#.#....#
.#....####.
h..........
.#######...
.#f.....#..
.#...#h....
..###......
........##.