water
...#......f
..##v#.####
.##..###..#
##...@...h.
.......#..#
###..###..#
..#..h....#
.##.##.#.##
.#......##.
.#.....##..
.#####.#...