cabbage
##..###....
........h#.
..#######..
.#......##.
..#.###.#..
.#..#f..#.v
....#####.#
...v..#.#.#
.##...#.#..
..#.###.##.
v.#.#@.....