winter
....#.....#
.##.#.###..
...##....#f
#....###.##
.v.#.....#.
.#########.
....h#.....
..####.#.##
h......#...
@.##.#.##..
###..#v....